,name,tmm,lm,lc,dc,lpl,smells
0,hidroh/materialistic,39,1,0,4,0,44
1,gsantner/memetastic,9,1,0,8,0,18
2,fenimore/DemocracyDroid,1,0,0,2,0,3
3,ctodobom/OpenNoteScanner,3,5,2,3,0,13
4,HugoGresse/Anecdote,4,0,0,3,0,7
5,greenaddress/abcore,0,1,0,0,0,1
6,mkulesh/microMathematics,35,24,8,9,1,77
7,vijai1996/screenrecorder,6,1,0,1,0,8
8,gsantner/markor,18,7,0,3,4,32
9,SecUSo/privacy-friendly-pedometer,8,6,0,9,0,23
10,philliphsu/ClockPlus,14,1,0,0,0,15
11,Sparker0i/Weather,3,2,0,4,0,9
12,ScreamingHawk/android-slideshow,1,1,0,2,0,4
13,openintents/notepad,3,7,2,0,0,12
14,jtmcn/archwiki-viewer,0,0,0,1,0,1
15,kwantam/batsHIIT,1,1,0,0,0,2
16,commons-app/apps-android-commons,27,5,1,16,3,52
17,Cj-Malone/Screens,0,1,0,0,0,1
18,MarcelJurtz/MTG_LifeCounter,3,1,0,0,0,4
19,OpenArchive/openarchive,3,3,0,2,0,8
20,erickok/transdroid,23,26,2,12,3,66
21,kollerlukas/Camera-Roll-Android-App,13,10,2,3,0,28
22,T-Rex96/Easy_xkcd,4,4,1,0,0,9
23,TobiasBielefeld/Simple-Brick-Games,4,5,1,0,0,10
24,TheTorProject/ooniprobe-android,0,0,0,4,1,5
25,MCMrARM/revolution-irc,22,5,0,1,1,29
26,andOTP/andOTP,4,7,0,0,0,11
27,qqq3/inventum,5,0,0,0,0,5
28,HenriDellal/emerald,3,1,0,2,0,6
29,tengusw/share_to_clipboard,0,0,0,0,0,0
30,arnef/bewegungsmelder-android,1,1,0,4,0,6
31,SecUSo/privacy-friendly-dice-game,0,1,0,0,0,1
32,itds-consulting/android-silent-ping-sms,1,0,0,0,0,1
33,gilbsgilbs/freemobilenetstat,4,9,0,1,0,14
34,BiglySoftware/BiglyBT-Android,45,40,12,8,0,105
35,btimofeev/UniPatcher,2,1,0,2,0,5
36,Andre1299/TUI-ConsoleLauncher,17,28,9,6,4,64
37,adolfintel/chromiumUpdater,0,1,0,0,0,1
38,termux/termux-app,13,17,1,0,3,34
39,tananaev/rootless-logcat,0,0,0,0,0,0
40,sergstetsuk/CosyDVR,1,2,0,0,0,3
41,caarmen/network-monitor,6,1,0,0,1,8
42,termux/termux-styling,0,0,0,0,0,0
43,TheUberCatman/crates-io-android,0,1,0,1,0,2
44,j4velin/Pedometer,5,2,0,0,0,7
45,micolous/metrodroid,10,20,1,4,0,35
46,wbrenna/GTFSOffline,0,7,0,0,0,7
47,caarmen/nounours-android,3,0,0,0,1,4
48,Etar-Group/Etar-Calendar,32,42,11,5,7,97
49,SteamGifts/SteamGifts,11,3,0,13,1,28
50,AnaelMobilia/NextINpact-Unofficial,2,10,1,3,0,16
51,scoute-dich/HHSMoodle,1,6,0,0,0,7
52,joonatoona/OpenShift,0,0,0,0,0,0
53,maks/MGit,6,0,0,0,0,6
54,meoblast001/thugaim,3,0,0,0,0,3
55,Tortel/SysLog,6,12,2,3,4,27
56,pR0Ps/LocationShare,1,0,0,0,0,1
57,dftec-es/planetcon,6,4,2,0,1,13
58,saschpe/BirthdayCalendar,1,2,0,1,0,4
59,EvanRespaut/Equate,7,4,1,0,0,12
60,alaskalinuxuser/app_hourglass,1,1,0,0,0,2
61,Neamar/KISS,6,3,0,3,0,12
62,qqq3/good-weather,1,0,0,1,0,2
63,TripSit/tripmobile,4,0,0,1,0,5
64,y20k/transistor,5,1,2,1,1,10
65,geecko86/QuickLyric,8,12,1,2,0,23
66,richsmith/sexytopo,13,0,1,0,0,14
67,icechen1/Notable,2,1,0,3,0,6
68,quaap/SeafoodBerserker,3,1,0,0,0,4
69,Gittner/OSMBugs,1,3,0,0,1,5
70,oliexdev/openScale,12,5,0,3,0,20
71,termux/termux-widget,0,0,0,0,0,0
72,guardianproject/ripple,0,0,0,0,0,0
73,termux/termux-float,2,0,0,0,0,2
74,capitoledulibre/cdl-companion-android,6,3,0,6,0,15
75,gjedeer/mylocation,1,0,0,0,0,1
76,SecUSo/privacy-friendly-shopping-list,4,3,0,21,0,28
77,vanilla-music/vanilla-music-cover-fetch,1,0,0,0,0,1
78,scoute-dich/K9-MailClient,114,51,21,12,2,200
79,veniosg/Dir,13,0,0,1,0,14
80,greenaddress/GreenBits,387,78,69,21,5,560
81,flyve-mdm/android-inventory-agent/,0,0,0,3,0,3
82,marunjar/anewjkuapp,13,10,1,9,3,36
83,anselm94/Torchie-Android,6,0,0,0,1,7
84,WangDaYeeeeee/Mysplash,63,2,2,24,0,91
85,DecentralizedAmateurPagingNetwork/DAPNETApp,3,0,0,8,0,11
86,butzist/ActivityLauncher,0,0,0,0,0,0
87,francescosoave/TIS_android,0,0,0,0,0,0
88,tranquvis/SimpleSmsRemote,5,2,0,7,0,14
89,RyuzakiKK/NoteCrypt,2,1,0,0,0,3
90,h42i/d00r-app,0,0,0,2,0,2
91,westnordost/StreetComplete,37,0,0,7,3,47
92,linuxtage/glt-companion,6,3,0,6,0,15
93,gentlecat/Simple-Counter/,3,0,0,0,0,3
94,thuryn/your-local-weather,9,11,2,7,6,35
95,abrensch/brouter,19,30,2,1,0,52
96,reloZid/android-anuto,15,0,0,0,0,15
97,VREMSoftwareDevelopment/WifiAnalyzer,22,1,0,1,0,24
98,domogik/domodroid,10,44,7,10,6,77
99,mikifus/padland,5,1,0,0,0,6
100,Sensirion/SmartGadget-Android,12,0,0,1,0,13
101,TobiasBielefeld/Simple-Solitaire,28,6,2,0,0,36
102,kaputnikGo/LittleSirEcho,1,0,0,0,0,1
103,meefik/busybox,0,0,0,0,0,0
104,SufficientlySecure/calendar-import-export,3,3,1,0,0,7
105,vanilla-music/vanilla-music-tag-editor,0,1,0,0,0,1
106,openintents/shoppinglist,8,16,4,1,0,29
107,rootkiwi/an2linuxclient,2,4,0,1,0,7
108,janoliver/pOT-Droid,14,10,1,5,0,30
109,shlusiak/Freebloks-Android,11,10,2,3,1,27
110,rdoeffinger/Dictionary,3,6,1,0,0,10
111,brarcher/rental-calc,8,14,0,0,0,22
112,vitas/beaconloc,9,1,0,3,0,13
113,dimtion/Shaarlier,0,0,0,4,0,4
114,hypeapps/Endoscope,13,4,0,0,0,17
115,quaap/PhoneFoneFun,1,0,0,0,0,1
116,ccrama/Slide,40,178,13,9,5,245
117,afollestad/nock-nock,0,0,0,0,0,0
118,raphaelm/c3nav-android/,1,1,0,0,0,2
119,nerzhul/ownCloud-SMS-App,1,0,0,0,0,1
120,aragaer/jtt_android,0,0,0,0,0,0
121,openfoodfacts/openfoodfacts-androidapp,17,19,2,27,2,67
122,vector-im/riot-android,37,72,18,3,1,131
123,ScreamingHawk/fate-sheets,0,0,0,7,0,7
124,termux/termux-tasker,0,0,0,0,0,0
125,mikljohansson/retroboy,3,2,1,1,0,7
126,vuze/vuze-remote-for-android,36,47,14,6,0,103
127,genonbeta/TrebleShot,18,15,1,9,1,44
128,ciubex/dscautorename,9,1,3,1,0,14
129,vanilla-music/vanilla-music-lyrics-search,1,0,0,0,0,1
130,y20k/trackbook,4,1,0,0,2,7
131,stom79/mastalab,8,59,7,17,0,91
132,quaap/BookyMcBookface,5,3,1,1,0,10
133,nextcloud/android,67,25,10,8,6,116
134,no-go/AnotherRSS,0,3,0,0,0,3
135,axxapy/apkExtractor,0,0,0,0,0,0
136,rascarlo/AURdroid,2,0,0,4,0,6
137,bpeel/prevo,2,1,0,0,0,3
138,scoute-dich/Weather,0,13,0,0,0,13
139,no-go/TextThing,1,2,0,0,0,3
140,takke/DataStats,3,2,0,1,0,6
141,trezor/trezor-android,224,22,33,9,2,290
142,GunshipPenguin/open_flood,1,0,0,0,0,1
143,cgogolin/library,2,7,1,0,0,10
144,nilesr/United4,3,1,0,0,0,4
145,TTTDevs/NextCloudBookmarksAndroid,0,0,0,0,0,0
146,tjg1/nori,6,0,1,2,0,9
147,metinkale38/namaz-vakti-android,17,18,3,2,0,40
148,SecUSo/privacy-friendly-memo-game,1,0,0,0,0,1
149,mo271/guessaday,0,1,0,0,0,1
150,theScrabi/OCBookmarks,0,0,0,0,0,0
151,souch/SMP,5,2,1,4,1,13
152,SecUSo/privacy-friendly-passwordgenerator,1,4,0,1,1,7
153,theScrabi/Terminightor,0,0,0,0,0,0
154,aario/killcamera,0,0,0,0,0,0
155,gateship-one/odyssey,17,4,2,1,0,24
156,owncloud/android/,46,26,6,3,0,81
157,jatwigg/cmus-android-remote,0,0,0,0,0,0
158,proninyaroslav/libretorrent,0,0,0,0,0,0
159,stefan-niedermann/nextcloud-notes,5,0,0,2,0,7
160,chaosdorf/meteroid,1,1,0,2,0,4
161,js-labs/ShellsMP,3,7,1,1,2,14
162,SecUSo/privacy-friendly-sudoku,5,6,1,4,0,16
163,vackosar/search-based-launcher/,2,0,0,1,0,3
164,brarcher/loyalty-card-locker,1,3,0,0,0,4
165,PowerInside/syncplayer,3,3,0,0,0,6
166,httpdispatch/MissedNotificationsReminder,8,3,1,1,1,14
167,rignaneseleo/SlimSocial-for-Facebook,4,1,1,0,0,6
168,xbmc/Kore,38,10,1,49,3,101
169,schnatterer/nusic,4,0,0,3,3,10
170,tejado/Authorizer,24,18,4,4,3,53
171,CityZenApp/Android-Development,6,1,0,4,1,12
172,franciscofranco/Simple-Reboot-app,0,0,0,0,0,0
173,mosmetro-android/mosmetro-android,3,5,0,0,0,8
174,vishesh/sealnote,4,1,0,0,0,5
175,openfoodfacts/openfoodfacts-androidapp,17,19,2,27,2,67
176,jonan/ForkHub,29,4,0,2,1,36
177,biylda/WhereYouGo,14,5,0,6,1,26
178,wizmer/syncorg,8,3,0,0,0,11
179,asnelt/derandom,4,1,1,0,1,7
180,manuelsc/Lunary-Ethereum-Wallet,8,6,0,6,1,21
181,etesync/android,6,4,0,1,0,11
182,graham22/Classic,16,3,0,5,0,24
183,VladThodo/behe-keyboard,1,1,1,0,0,3
184,ndleyton/OneTwo,2,1,0,1,0,4
185,alaskalinuxuser/app_justnotes,0,5,0,0,0,5
186,42SK/TVKILL,1,0,0,0,0,1
187,lexica/lexica,8,0,0,0,0,8
188,openintents/flashlight,1,1,0,0,0,2
189,farmerbb/Taskbar,5,16,2,3,0,26
190,citiususc/calendula,28,5,2,25,1,61
191,no-go/ViboraFeed,0,0,0,0,0,0
192,EXL/Snooder21,2,1,1,0,0,4
193,jonasoreland/runnerup/,33,18,2,5,0,58
194,microg/android_packages_apps_UnifiedNlp,5,0,1,2,1,9
195,brarcher/gift-card-guard,1,1,0,0,0,2
196,Kestutis-Z/World-Weather,4,4,1,3,0,12
197,dkim0419/SoundRecorder,1,0,0,0,0,1
198,seizonsenryaku/HayaiLauncher,1,0,0,0,0,1
199,segler-alex/RadioDroid,11,2,0,3,0,16
200,fython/Blackbulb,5,4,1,1,0,11
201,fossasia/open-event-android,0,0,0,0,0,0
202,aravindsagar/ScreenShift,7,0,1,0,0,8
203,openfoodfacts/openfoodfacts-androidapp,17,19,2,27,2,67
204,milesmcc/LibreNews-Android,0,1,0,1,0,2
205,CriticalMaps/criticalmaps-android,5,0,0,0,0,5
206,gsantner/kimai-android,3,0,0,1,0,4
207,theScrabi/OCBookmarks,0,0,0,0,0,0
208,termux/termux-api,0,8,0,0,0,8
209,scoute-dich/Sieben,1,38,0,0,0,39
210,gstraube/cythara,7,27,2,3,2,41
211,markusfisch/ShaderEditor,7,2,2,1,0,12
212,LukeStonehm/LogicalDefence,0,0,0,0,0,0
213,alijc/CricketsAlarm,2,0,0,0,0,2
214,durka/HallMonitor,5,1,2,0,0,8
215,erickok/transdroid,23,26,2,12,3,66
216,phunehehe/fooCam,1,0,0,0,0,1
217,threedliteguy/UhLocationReportingService,1,0,0,0,0,1
218,grote/BlitzMail,0,0,0,0,0,0
219,taky/effy,0,0,0,0,0,0
220,boztalay/PuppyFrame,1,0,0,0,0,1
221,pejic/Summation,0,0,0,0,0,0
222,anupam1525/AcrylicPaint,0,1,0,0,0,1
223,alt236/Android-Drawables---Android,1,0,2,0,0,3
224,headrevision/BehatReporter,2,0,0,0,0,2
225,dynalogin/dynalogin-android,1,1,1,0,0,3
226,mathbellev/StdAtmosphere,3,0,4,0,0,7
227,dnet/adsdroid,0,0,0,0,0,0
228,OEP/rainwave-android,4,4,1,1,0,10
229,jufickel/rdt,1,0,0,0,0,1
230,yuttadhammo/E-Tipitaka-for-Android,9,10,2,4,1,26
231,cbeyls/fosdem-companion-android,5,3,0,6,0,14
232,Smerty/zooborns.android,0,1,0,2,0,3
233,billthefarmer/tuner,1,4,1,0,0,6
234,hgdev-ch/toposuite-android,30,13,0,39,9,91
235,AndlyticsProject/andlytics,15,12,1,13,1,42
236,devonjones/PathfinderOpenReference,8,1,0,11,1,21
237,cmykola/Lexin,7,10,1,0,1,19
238,ZorgeR/nanoConverter,1,2,1,0,0,4
239,ValleZ/Paper-Wallet,9,14,4,3,1,31
240,ojacquemart/vlilleChecker,7,0,0,1,0,8
241,gwhiteside/abstract-art,2,3,0,0,0,5
242,yhcting/netmbuddy,17,2,4,2,0,25
243,arifhn/nstools,2,1,0,3,0,6
244,koelleChristian/trickytripper,24,11,2,18,1,56
245,mjdenham/and-bible,25,2,0,7,0,34
246,rafi-kamal/Bangla-Dictionary,0,0,0,1,0,1
247,vx/connectbot,28,38,9,17,2,94
248,irssiconnectbot/irssiconnectbot,27,36,7,17,2,89
249,concentricsky/android-viewer-for-khan-academy,12,7,1,11,0,31
250,chemicalappspace/Isotopes,0,0,0,0,0,0
251,xgouchet/Ted,2,0,0,0,0,2
252,DocSalvi/LinuxDayAppAndroid,2,0,0,1,0,3
253,yourealwaysbe/teacup,4,0,1,1,1,7
254,QuantumBadger/RedReader,30,53,2,6,6,97
255,klassm/andFHEM,6,1,0,6,0,13
256,ultramega/elementary,1,0,2,0,1,4
257,slapperwan/gh4a,50,9,0,4,10,73
258,romario333/opensudoku,10,4,0,0,0,14
259,qii/weiciyuan,55,24,5,36,3,123
260,czlee/debatekeeper,5,3,1,0,0,9
261,mick88/filemanager,3,0,0,0,0,3
262,ginkel/hashit,2,1,0,0,0,3
263,bpellin/keepassdroid,19,6,2,2,0,29
264,LittleFox94/PGPAuth,0,0,0,0,0,0
265,maxfierke/sandwichroulette,1,0,0,2,0,3
266,j4velin/SystemAppMover,0,3,0,0,0,3
267,andybotting/tramhunter,2,2,0,6,0,10
268,danieloeh/AntennaPod,60,15,7,16,7,105
269,aarddict/android,6,1,1,1,0,9
270,nephoapp/anarxiv,2,2,0,0,0,4
271,geometer/FBReaderJ,64,32,7,11,8,122
272,Pansanel/cetoolbox,0,5,0,1,0,6
273,feelinglucky/Presentation,0,0,0,0,0,0
274,open-keychain/open-keychain,68,48,9,6,2,133
275,ankidroid/Anki-Android,46,24,7,12,0,89
276,fivasim/Antikythera-Simulation,0,3,0,0,0,3
277,Tyde/TuCanMobile,0,2,0,1,1,4
278,dennischen/daily-money,16,5,0,9,1,31
279,hwki/SimpleBitcoinWidget,0,0,0,0,0,0
280,zikalify/BMI_Calculator,0,0,0,0,0,0
281,roelb/Simple-C25K,2,3,0,0,0,5
282,yuttadhammo/BodhiTimer,1,5,1,0,0,7
283,yanchenko/droidparts-battery-widget,0,0,0,0,0,0
284,lordi/tickmate,4,3,0,1,0,8
285,dougkeen/BartRunnerAndroid,6,3,0,6,0,15
286,ybonnel/TransportsRennes,8,11,0,15,0,34
287,danielme-com/Muspy-for-Android,4,0,0,14,2,20
288,zagaberoo/diode,12,11,3,9,1,36
289,monakhv/samlib-Info,22,5,2,12,0,41
290,jagossel/MovingPolygons,1,0,0,0,0,1
291,plusonelabs/calendar-widget,5,0,0,0,0,5
292,alterechtschreibung/MonthCalendarWidget2FOSS,2,3,0,0,1,6
293,illarionov/RtkGps,8,4,0,0,5,17
294,asksven/BetterBatteryStats,7,40,4,2,10,63
295,bvalosek/cpuspy,1,0,0,0,0,1
296,sanbeg/flashlight,0,0,0,0,0,0
297,intrications/intent-intercept,1,0,0,0,0,1
298,mozilla/MozStumbler,19,4,1,2,1,27
299,domoritz/open-mensa-android,1,0,0,0,0,1
300,OpenWatch/OpenWatch-Android,14,8,1,1,0,24
301,cybro/PalmCalc,38,16,10,2,0,66
302,xargsgrep/PortKnocker,2,0,0,5,0,7
303,DamienOReilly/PrepayCredit,1,1,0,1,0,3
304,wolpi/prim-ftpd,10,4,1,4,2,21
305,lpar/RPN,2,0,0,0,0,2
306,mportuesisf/ScreenInfo,2,0,0,0,0,2
307,gokhanmoral/STweaks,1,1,0,0,0,2
308,Vilbrekin/tinc_gui,2,0,0,0,0,2
309,adrian/upm-android,2,3,1,5,0,11
310,mafrosis/Wake-On-Lan,1,0,0,1,0,2
311,MiCode/FileExplorer,9,3,1,2,0,15
312,ambrice/timesheet,2,1,0,0,0,3
313,daryldy/Heart,2,0,0,0,0,2
314,onyxbits/pocketbandit,1,1,0,0,0,2
315,thialfihar/apg,27,46,5,6,0,84
316,cernekee/ics-openconnect,9,1,1,3,0,14
317,raphaelm/opacclient,37,51,11,21,0,120
318,cgeo/c-geo-opensource,75,35,14,11,6,141
319,inguin/moneybalance,4,1,0,2,0,7
320,mannd/epmobile,10,1,0,0,2,13
321,phw/PicardBarcodeScanner,1,0,0,1,0,2
322,manmal/hn-android,3,1,0,0,0,4
323,ParanoidAndroid/android_packages_apps_ParanoidWallpapers,0,0,0,0,0,0
324,romannurik/muzei,8,5,1,1,0,15
325,MohammadAdib/RoundR,1,1,1,1,0,4
326,eleybourn/Book-Catalogue,36,35,11,3,0,85
327,ebraminio/DroidPersianCalendar,9,7,2,2,2,22
328,azapps/mirakel-dashclock,0,1,1,0,0,2
329,dmfs/tasks,21,14,2,4,0,41
330,mobilepearls/com.mobilepearls.sokoban,0,0,1,0,0,1
331,SimonMarquis/Android-PreferencesManager,9,0,0,0,0,9
332,jackpal/Android-Terminal-Emulator,12,14,3,1,4,34
333,AnySoftKeyboard/AnySoftKeyboard,55,12,2,1,13,83
334,asksven/BetterWifiOnOff,0,7,0,1,0,8
335,adrian-bl/bl-battstatus-android,1,0,0,0,0,1
336,nolanlawson/Catlog,6,1,1,4,0,12
337,uberspot/DebianDroid,1,0,0,2,0,3
338,f2prateek/Device-Frame-Generator,5,1,0,0,2,8
339,kibab/encpasschanger,0,0,0,0,0,0
340,namsor/gendreapp,2,4,3,6,0,15
341,nolanlawson/KeepScore,11,2,2,7,2,24
342,msemm/Keypad-Mapper-3,36,19,13,11,1,80
343,hauckwill/linconnect-client,0,2,0,0,0,2
344,onyxbits/listmyaps,1,1,0,2,0,4
345,dschuermann/ntp-sync,10,5,0,5,0,20
346,eolwral/OSMonitor,27,7,2,0,4,40
347,jberkel/sms-backup-plus,18,0,0,3,2,23
348,momodalo/vimtouch,11,7,4,0,3,25
349,Yubico/yubioath-android,0,0,0,0,0,0
350,jarofgreen/Just-A-Damn-Compass,0,0,0,0,0,0
351,nguillaumin/osmtracker-android,6,4,0,0,0,10
352,Shahul3D/IndiaSatelliteWeather,4,4,3,2,0,13
353,iFixit/iFixitAndroid,22,5,1,6,0,34
354,grote/Liberario,5,0,0,2,1,8
355,daj/flashback,1,3,0,0,0,4
356,k9mail/k-9,134,41,16,14,6,211
357,joanpuigsanz/servdroid,9,3,0,0,0,12
358,ubergeek42/weechat-android,19,1,0,2,0,22
359,TKJElectronics/BalanduinoAndroidApp,1,4,0,1,0,6
360,withad/Mandelbrot-Maps-on-Android,2,0,0,1,1,4
361,nolanlawson/JapaneseNameConverterRoot,3,3,0,5,0,11
362,ShaneQful/Jupiter-Broadcasting-Android-App,0,0,0,0,0,0
363,veken0m/bitcoinium,6,6,0,15,1,28
364,codinguser/gnucash-android,30,11,3,1,0,45
365,mtotschnig/MyExpenses,73,33,6,10,1,123
366,bagilevi/android-pedometer,3,0,0,0,0,3
367,ghackett/AppAlarm,3,1,1,0,0,5
368,ralphleon/TeaTimer,1,0,0,0,0,1
369,wdkapps/FillUp,5,0,0,2,0,7
370,nikclayton/android-squeezer,25,10,3,13,0,51
371,MiCode/SoundRecorder,3,1,1,0,0,5
372,daneren2005/Subsonic,30,22,8,22,1,83
373,billthefarmer/accordion,1,0,1,0,0,2
374,micwallace/reddinator,12,11,2,1,0,26
375,ghisguth/blurred-lines-live,3,1,0,0,0,4
376,PuZZleDucK/Orbital-Live-Wallpaper,1,1,0,0,0,2
377,netmackan/ATimeTracker,4,1,1,0,0,6
378,dschuermann/birthday-adapter,1,2,0,1,0,4
379,maxpower47/PinDroid,8,0,0,5,1,14
380,tinkerlog/PongTime,1,0,0,0,0,1
381,sismics/reader,6,10,0,36,2,54
382,onyxbits/remotekeyboard,9,5,1,3,0,18
383,chibibi/simpleDeadlines,0,1,0,0,0,1
384,uberspot/2048-android,0,0,0,0,0,0
385,scoutant/blokish,5,0,0,0,0,5
386,tsapree/L9Droid,5,9,3,1,2,20
387,ukanth/afwall,15,25,4,6,0,50
388,yuriykulikov/AlarmClock,6,1,0,1,0,8
389,ilijamt/android-adbm,4,2,2,1,0,9
390,phw/Android-PwdHash,1,0,0,0,0,1
391,Sash0k/bluetooth-spp-terminal,1,0,0,1,0,2
392,felixb/callmeter,6,17,5,0,0,28
393,kaytdek/ColorNamer,2,0,0,0,0,2
394,MiCode/Compass,0,0,0,0,0,0
395,dschuermann/faster-gps,4,1,0,0,0,5
396,jakebasile/hearing-saver,0,1,0,0,0,1
397,ikarus23/MifareClassicTool,6,8,3,0,0,17
398,fixme-lausanne/MyHackerspace,1,3,0,0,0,4
399,hrk/no-frills-cpu-classic,0,2,0,0,0,2
400,lkorth/screen-notifications,3,0,0,2,0,5
401,project-voodoo/simple_carrieriq_detector_app,1,0,0,0,0,1
402,robert7k/sipswitch,0,0,0,0,0,0
403,tananaev/traccar-client-android,2,0,0,1,0,3
404,Softcatala/TraductorSoftcatalaAndroid,3,0,0,0,0,3
405,pilot51/voicenotify,1,1,0,0,0,2
406,rahulaga/WorldClock,0,0,0,0,0,0
407,restorer/Gloomy-Dungeons-3D,10,16,3,4,1,34
408,vocollapse/Blockinger,5,3,0,1,0,9
409,uberspot/AnagramSolver,0,0,0,0,0,0
410,geometer/FBReaderJ-plugin-local-opds-scanner,1,0,0,1,0,2
411,szym/barnacle,2,1,0,0,0,3
412,rigid/Birthdroid,0,2,0,0,0,2
413,anthonycr/Lightning-Browser,6,3,1,2,0,12
414,guardianproject/orweb,2,3,2,1,0,8
415,firetech/PactrackDroid,3,1,0,0,0,4
416,redsolution/xabber-android,57,21,5,46,21,150
417,TCA-Team/TumCampusApp,16,1,0,1,0,18
418,ge0rg/gamemasterdice,1,0,0,0,0,1
419,Xlythe/MinecraftClock,1,0,0,0,0,1
420,GiorgioRegni/Binaural-Beats,3,3,1,2,3,12
421,mehmetakiftutuncu/eshotroid,1,0,0,2,0,3
422,osmandapp/Osmand,387,194,99,95,31,806
423,jpeddicord/speedofsound,0,0,0,0,0,0
424,adrian-bl/vanilla,0,0,0,0,0,0
425,JesusFreke/Penroser,1,1,0,1,0,3
426,jruesga/PhotoPhase,11,6,2,1,0,20
427,vomitcuddle/nori,6,0,1,2,0,9
428,BrandroidTools/OpenExplorer,133,120,28,27,3,311
429,sudowars/sudowars,12,6,0,3,0,21
430,andstatus/andstatus,67,11,3,4,1,86
431,wordpress-mobile/WordPress-Android,157,44,17,2,3,223
432,YerayAlonso/LligaIntermunicipal,1,0,0,2,1,4
433,jecelyin/920-Text-Editor,14,30,7,2,16,69
434,nexes/Android-File-Manager,3,6,0,0,0,9
435,fmetzger/android-sensorium,1,2,0,2,0,5
436,ksksue/Android-USB-Serial-Monitor-Lite,1,2,0,0,0,3
437,litrik/be.norio.randomapp,0,0,0,0,0,0
438,tillwoerner/BrightnessWidget,1,1,0,0,0,2
439,jochem88/clean-calculator,1,4,0,0,0,5
440,pejic/EasyDice,3,0,0,0,0,3
441,herrlado/GeorgianFonts,2,0,0,0,0,2
442,borneq/HereGPSLocation,0,0,0,0,0,0
443,mtotschnig/SendWithFtp,1,0,0,0,0,1
444,onyxbits/sensorreadout,3,2,1,0,6,12
445,Buttink/sick-stache,5,2,0,4,0,11
446,koush/Superuser,1,3,0,0,0,4
447,wiglenet/wigle-wifi-wardriving,32,19,3,8,3,65
448,sozialhelden/wheelmap-android,23,10,1,20,1,55
449,MazeChaZer/WoT-Tank-Quiz,0,1,0,0,0,1
450,john-tornblom/TVHGuide,6,1,0,0,0,7
451,dozingcat/Vector-Pinball,13,0,0,2,0,15
452,geometer/FBReaderJ-plugin-tts,2,0,0,1,0,3
453,gregko/TtsPlus-FBReader,4,2,1,0,0,7
454,robotmedia/droid-comic-viewer,13,15,4,20,0,52
455,softgearko/MultiPing-for-Android,1,0,0,0,0,1
456,Anasthase/TintBrowserAdblockAddon,2,0,0,0,0,2
457,pocmo/Yaaic,8,4,2,5,0,19
458,ge0rg/yaxim,11,8,2,3,2,26
459,liato/android-bankdroid,7,4,1,11,2,25
460,niteshpatel/ministocks,7,2,0,3,0,12
461,mboesling/HydroMemo,0,0,0,0,0,0
462,zxing/zxing,27,20,0,18,9,74
463,bherrmann7/Car-Cast,9,6,3,3,0,21
464,billthefarmer/melodeon,1,0,0,0,0,1
465,tobykurien/GoogleNews,0,0,0,0,0,0
466,SimonMarquis/Android-SecretCodes,0,0,0,0,0,0
467,marin-liovic/Fast-Brightness-Control-Widget,0,0,0,1,0,1
468,lllllT/MultiPictureLiveWallpaper,5,14,1,3,1,24
469,dozingcat/AsciiCam,3,1,0,2,4,10
470,lightbox/QuickSnap,6,1,1,0,0,8
471,duncanje/android-open-wifi-network-remover,1,0,0,0,0,1
472,acl33/AndroidDasher,18,7,1,1,0,27
473,MirakelX/mirakel-android,45,27,7,13,10,102
474,sukso96100/SidePanel,29,11,14,3,0,57
475,paulmach/Text-Edit-for-Android,1,5,1,0,0,7
476,jamienicol/episodes,2,2,0,3,0,7
477,velazcod/Tinfoil-Facebook,2,0,0,0,0,2
478,moparisthebest/AppBak,1,2,1,0,0,4
479,lllllT/AtmosphereLogger,1,1,0,1,0,3
480,guardianproject/cacert,1,0,0,0,0,1
481,Smerty/ham.android,1,2,0,5,0,8
482,abcdjdj/RootVerifier-APP,0,0,0,0,0,0
483,sheimi/SGit,6,0,0,0,0,6
484,vmihalachi/turbo-editor,7,2,2,1,0,12
485,j4velin/WiFi-Auto-Off,1,3,0,0,2,6
486,hmrocha/wifiwidget,0,0,0,0,0,0
487,Chluverman/android-gltron,4,3,0,0,0,7
488,niparasc/papanikolis-submarine,5,2,0,6,0,13
489,TomTasche/OpenDocument.droid,5,3,0,2,0,10
490,balesz/android-WebSearch,1,0,0,0,0,1
491,guardianproject/Gibberbot,45,36,9,8,3,101
492,mateusz-szafraniec/NFCTagmaker,1,1,0,0,0,2
493,Anasthase/TintBrowser,18,11,1,0,0,30
494,rorist/Cowsay-android,0,0,0,0,0,0
495,F0x06/EddyMalou,0,1,0,0,0,1
496,gsingh93/hacker-live-wallpaper,4,0,0,0,0,4
497,schildbach/bitcoin-wallet,16,8,1,12,0,37
498,notriddle/budget-envelopes,8,1,0,1,1,11
499,mancio/Volume-Control,0,1,0,0,0,1
500,shakalaca/BeautyClockLiveWallpaper,4,0,0,0,0,4
501,umanx/DashNotifier,1,4,0,2,0,7
502,AChep/JellyBeanClock,0,0,0,0,0,0
503,msal/muzei-nationalgeographic,0,0,0,2,0,2
504,rjmarsan/Pixelesque,3,1,0,3,0,7
505,hsaito/hstempo_android,0,0,0,0,0,0
506,dschuermann/document-viewer,47,19,3,17,1,87
507,dschuermann/standalone-calendar,31,38,11,5,7,92
508,StanLivitski/n-puzzle,5,0,0,2,0,7
509,onyxbits/TextFiction,8,5,1,4,0,18
510,AnimaSA/Atarashii,14,4,1,4,0,23
511,loadrunner/Facebook-Contact-Sync,4,2,1,0,0,7
512,kromonos/Mustard-Mod,8,5,3,15,1,32
513,MohammadAG/android-file-beam,1,0,0,0,0,1
514,scar45/aokp-co-webviewer,0,0,0,0,0,0
515,hmrocha/batterywidget,0,0,0,0,0,0
516,zaren678/Hdhomerun-signal-meter,2,1,0,0,0,3
517,mborjesson/LG-Optimus-2X-Black-Notifications,2,6,2,0,0,10
518,Mobiperf/MobiPerf,5,7,2,6,1,21
519,SpazeDog/mounts2sd,4,6,0,0,0,10
520,felixb/otpdroid,1,1,0,0,0,2
521,mvglasow/satstat,8,5,0,11,1,25
522,cprados/wifimatic-android,4,1,1,0,0,6
523,mendhak/gpslogger,8,7,3,2,4,24
524,NightWhistler/PageTurner,14,5,3,13,0,35
525,HoloAddict/FeedEx,1,1,0,0,0,2
526,Kent1/Manille,0,1,0,2,0,3
527,felixb/smsdroid,2,5,0,0,0,7
528,ushahidi/SMSSync,31,1,0,14,2,48
529,wrr/speech_trainer,4,0,0,1,0,5
530,cr5315/countdown-for-dashclock,1,0,0,0,0,1
531,dozingcat/CamTimer,4,0,0,0,0,4
532,dsoulayrol/android-sholi,1,0,0,1,0,2
533,edsonduarte1990/reminders,0,0,0,1,0,1
534,dpadgett/Timer,2,3,1,1,0,7
535,chrispbailey/ToDo-List-Widget,2,2,0,0,0,4
536,brosmike/AirPush-Detector,1,0,0,0,0,1
537,tasermonkey/android-passwordmaker,5,2,0,1,0,8
538,tstein/AndroSS,1,3,0,0,0,4
539,janosgyerik/bluetoothviewer,1,0,0,0,0,1
540,wanleung/ChangjieIME,1,0,0,0,0,1
541,easytiger/dotty,0,0,0,1,0,1
542,project-voodoo/ota-rootkeeper-app,0,0,0,0,0,0
543,jerickson314/sdscanner,2,0,0,0,0,2
544,alt236/USB-Device-Info---Android,1,0,0,1,0,2
545,onyxbits/geobookmark,0,0,0,0,0,0
546,mdecorde/BAC76,1,0,0,0,0,1
547,trishika/DroidUPnP,6,2,1,3,0,12
548,intervigilium/MicDroid,2,0,0,0,0,2
549,mateuszbuda/ThermometerExtended2,2,0,0,1,0,3
550,xenris/liquid-wars-android,6,0,0,0,0,6
551,jfreax/OpenLaw,2,2,1,4,0,9
552,DizzyThermal/Auto-Away,6,4,0,5,0,15
553,guardianproject/PixelKnot,2,1,1,1,1,6
554,awaken/sanity,19,1,0,0,0,20
555,NewProggie/SparkleShare-Android,1,0,0,1,0,2
556,johnnylambada/WorldMap,1,0,0,0,0,1
557,banasiak/CoinFlip,1,1,0,0,1,3
558,prismsw/Lampshade,4,0,0,3,0,7
559,teamOSC/SubtleNews_Android_App,1,1,0,0,0,2
560,budowski/budoist,11,12,2,2,0,27
561,weisserd/LDAP-Sync,0,0,0,2,0,2
562,teneighty/moss,4,1,0,0,0,5
563,yankovskiy/SilentNight,2,0,1,0,0,3
564,indrora/Atomic,15,14,4,2,1,36
565,tobykurien/BatteryFu,3,3,0,0,0,6
566,jyio/botbrew-gui,4,1,0,4,0,9
567,felixb/clipboard-beam,0,0,0,0,0,0
568,blaztriglav/did-i,0,1,0,2,0,3
569,palfrey/postcode,0,0,0,0,0,0
570,pyload/pyload-android,27,15,5,3,2,52
571,Nutomic/control-dlna,4,0,0,1,0,5
572,emergentdotorg/shaman,14,1,1,4,0,20
573,cketti/DashClock_K-9,1,0,0,0,0,1
574,timvdalen/gizmooi,0,0,0,1,0,1
575,gggard/AndroidCaldavSyncAdapater,7,9,3,18,0,37
576,nfd/KeePassNFC,2,0,0,0,0,2
577,matburt/mobileorg-android,7,3,0,0,0,10
578,losttime/cooper,3,0,0,2,0,5
579,miracle2k/android-autostarts,5,8,1,1,0,15
580,pires/android-obd-reader,1,1,0,2,0,4
581,rmtheis/android-ocr,2,4,1,2,1,10
582,adrian-bl/APN-Switch,1,0,0,0,0,1
583,flyingrub/SpeedMeter,1,1,0,0,0,2
584,mariotaku/twidere.extension.twitlonger,1,0,0,1,0,2
585,Zanshinmu/Wifi-Fixer,8,0,1,2,0,11
586,freezy/android-xbmcremote,72,12,8,4,4,100
587,btmura/rbb,40,3,2,5,5,55
588,MarcDufresne/BetterWeather,4,3,0,1,0,8
589,indication/OpenRedmine,24,4,0,14,0,42
590,MaTachi/geometri-destroyer,4,1,0,1,0,6
591,awilliams/fish,0,0,0,0,0,0
592,nathanpc/Build.prop-Editor,1,0,0,0,0,1
593,Nilhcem/hosts-editor-android,2,0,0,0,0,2
594,elek/osmgpxuploader,0,1,0,3,0,4
595,ShowMeHills/ShowMeHills,3,2,1,0,0,6
596,prrt714/Kaleidoscope,3,1,0,0,0,4
597,logomancer/dashquotes-civ5,0,0,0,0,0,0
598,onyxbits/Drudgery,1,0,0,2,0,3
599,amiga/sonorox,5,4,3,0,0,12
600,jurihock/voicesmith,3,1,0,1,0,5
601,markusfisch/WaveLinesWallpaper,4,1,0,0,0,5
602,voidcode/Diaspora-Webclient,0,1,0,0,0,1
603,sweetiepiggy/Every-Locale,0,0,0,0,0,0
604,codebutler/farebot,9,6,1,2,1,19
605,guardianproject/gnupg-for-android,10,1,0,1,0,12
606,atd/HandyNotes,0,0,0,0,0,0
607,guardianproject/lildebi,2,1,0,0,0,3
608,nadam/nfc-reader,1,0,0,0,0,1
609,xenotropic/quizzn,0,1,0,0,0,1
610,chaosbastler/opentraining,5,8,0,4,0,17
611,telecapoland/jamendo-android,7,2,0,8,0,17
612,thasmin/Podax,11,7,1,4,0,23
613,clementine-player/Android-Remote,85,15,9,1,0,110
614,danielegobbetti/ICSImport,0,0,0,0,0,0
615,ajaapps/flightmode,1,0,0,0,0,1
616,cglapa/rights-alert,0,0,0,1,0,1
617,zaki50/MemoPad,3,2,0,0,0,5
618,rtyley/agit,11,1,0,0,0,12
619,baolongnt/EmailPopup,0,3,0,0,0,3
620,opentelecoms-org/lumicall,20,18,1,4,3,46
621,lablogga/DIYgenomics_Android,1,0,0,0,0,1
622,Kaljurand/Diktofon,5,0,0,0,0,5
623,SASAbus/SASAbus,9,9,0,22,2,42
624,guardianproject/notecipher,3,0,0,0,0,3
625,anthonydahanne/ReGalAndroid,6,3,0,11,2,22
626,threedliteguy/urforms,1,4,0,3,0,8
627,nolanlawson/ChordReaderRoot,2,1,1,4,0,8
628,boombuler/piraten_map_app,78,8,16,0,0,102
629,soft-studio/NFC_DriversLicenseReader,2,43,6,3,14,68
630,moparisthebest/PagePlusBalance,0,1,0,0,0,1
631,tom-and-jerry/eyeCam,1,0,0,0,0,1
632,NightlyNexus/Color-Clock,0,0,0,0,0,0
633,ajlyon/zandy,6,16,2,2,0,26
634,nicolas-raoul/OxygenGuide-Android,0,0,0,0,0,0
635,pettarin/epub3reader,3,2,0,0,0,5
636,Xlythe/HexGame_Android,6,1,0,4,0,11
637,talklittle/reddit-is-fun,11,7,3,6,0,27
638,wallabag/android-app,13,10,1,8,2,34
639,oschina/android-app,20,33,4,20,0,77
640,mconf/sipdroid,36,16,2,1,4,59
641,sagemath/android,9,2,0,9,0,20
642,owncloud/android,46,26,6,3,0,81
643,justin66/MyTracks,52,7,2,11,2,74
644,github/android,21,1,0,3,1,26
645,cyclestreets/android,23,1,1,2,2,29
646,felixb/websms,4,5,1,2,0,12
647,osmdroid/osmdroid,40,26,1,17,4,88
648,skhang/appsorganizer,27,0,0,7,0,34
